#########################
#.........  ............#
#.......................#
#.......................#
#..........#####........#
#.........#....#........#
#.........#....####.....#
#.........#......G.#....#
#.........#.....G.#.....#
#.......###...#####.....#
#.............#.........X
#.......###.###.........X
#####.....#.#...........#
#...#.....#.#...........#
#...#.....#.#...........#
#...#######.######......#
#................#......#
#................#......#
#................#......#
#.............####......#
#.............#.........#
#.............#.........#
#.............#.........#
#@......................#
#########################

