#########################
#########################
##.....................##
##.....................##
##.....................##
##.....................##
##.....................##
##.....................##
##.....................##
##.....................##
##.....................##
##.....................##
##.....................XX
##.....................XX
##.....................##
##.....................##
##.....................##
##.....................##
##.....................##
##.....................##
##.....................##
##.....................##
##.....................##
###########XX############
###########XX############
