###########QQ############
#.......................#
#..######################
#.......................#
######################..#
#.......................#
#..######################
#.......................#
######################..#
#.......................#
#..######################
#.......................#
######################..#
#....................#..#
#....................#..#
#....................#..#
#....................#..#
#.......................#
#...........#......######
#...........#......#....#
#...........#GGGGGG#....#
#...........#GGGGGG#....#
#...........########....#
#.......................#
###########XX############
